# 二简
表示	be
并且	bq
不同	bt
不行	bx
不要	by
从此	cc
错过	cg
聪明	cm
采取	cq
操心	cx
电脑	dn
大小	dx
上次	ec
说明	em
使用	ey
服从	fc
中国	fg
符合	fh
父母	fm
刚才	gc
赶快	gk
光明	gm
花草	hc
很快	hk
后面	hm
快餐	kc
可靠	kk
开门	km
两年	ln
明天	mt
梦想	mx
满意	my
哪怕	np
平时	pe
脾气	pq
平台	pt
平安	px
拼音	py
如此	rc
人工	rg
如何	rh
人们	rm
日期	rq
染色	rs
热线	rx
三次	sc
搜狗	sg
算吗	sm
索取	sq
思想	sx
太难	tn
提前	tq
同学	tx
为此	wc
外面	wm
完全	wq
因此	yc
以及	yj
郁闷	ym
一年	yn
要求	yq
有人	yr
以下	yx
因而	yx
字词	zc
做饭	zf
字根	zg
在吗	zm
组长	zq
昨天	zt
仔细	zx