# 一简二重
又	a
吧	b
都	d
识	e
实	e
支	f
好	h
打	i
及	j
啦	l
嘛	m
能	n
着	o
期	q
嗯	x
意	y
愈	y
越	y
玩	w
咋	z
# 二简二重
叭	bs
氏	ek
视	ek
砚	yf
脚	jc
届	jd
急	jk
呵	he
屁	pk
噗	pj
喂	ww
重	wy
兮	xk
哟	yl
咦	yk
噫	yk
哇	ws
啧	ze
嘁	qk
耶	ye